1111111
1P00t01
1000001
1000001
1C000E1
1111111
