1111111111101
100000000C001
100E011111001
1P00110000001
1111111111111
