1111111111111
100100000C001
100E011111000
1P00110000001
1111111111111
