1111111111111
1P00000000001
100C0000C0001
1000000000001
1000000000001
1000000000001
1000000000001
1000000000001
1000000000001
10C0000000C01
100CCCCCCC001
10000000000E1
1111111111111
