111111111
1C01P10C1
100000001
110000011
1C00100C1
100111001
1000E0001
101111101
100000001
100011011
1001C0001
101C00011
111111111
